;;
;; Table of predefined combinations for Vietnamese Telex/VNI users.
;;
;; This table is generated from the original table from the branch `scim`.
;; Once this table is manually edit, the generator must be disabled and
;; any further udpate must be done carefully.
;;
;; This work is distributed under the terms of the license GPL (v2).
;; To use this work you must read and accept the license that's found at
;;   http://www.gnu.org/licenses/gpl-2.0.html
;;
A	A
D	D
E	E
G	G
I	I
O	O
Q	Q
U	U
W	W
Y	Y
a	a
d	d
e	e
g	g
i	i
o	o
q	q
u	u
w	w
y	y
AA	Â
AC	AC
AF	À
AI	AI
AJ	Ạ
AM	AM
AN	AN
AO	AO
AP	AP
AR	Ả
AS	Á
AT	AT
AU	AU
AW	Ă
AX	Ã
AY	AY
Aa	Â
Ac	Ac
Af	À
Ai	Ai
Aj	Ạ
Am	Am
An	An
Ao	Ao
Ap	Ap
Ar	Ả
As	Á
At	At
Au	Au
Aw	Ă
Ax	Ã
Ay	Ay
DD	Đ
Dd	Đ
EC	EC
EE	Ê
EF	È
EJ	Ẹ
EM	EM
EN	EN
EO	EO
EP	EP
ER	Ẻ
ES	É
ET	ET
EX	Ẽ
Ec	Ec
Ee	Ê
Ef	È
Ej	Ẹ
Em	Em
En	En
Eo	Eo
Ep	Ep
Er	Ẻ
Es	É
Et	Et
Ex	Ẽ
GI	GI
Gi	Gi
IA	IA
IC	IC
IE	IE
IF	Ì
IJ	Ị
IM	IM
IN	IN
IP	IP
IR	Ỉ
IS	Í
IT	IT
IU	IU
IX	Ĩ
Ia	Ia
Ic	Ic
Ie	Ie
If	Ì
Ij	Ị
Im	Im
In	In
Ip	Ip
Ir	Ỉ
Is	Í
It	It
Iu	Iu
Ix	Ĩ
OA	OA
OC	OC
OE	OE
OF	Ò
OI	OI
OJ	Ọ
OM	OM
ON	ON
OO	Ô
OP	OP
OR	Ỏ
OS	Ó
OT	OT
OW	Ơ
OX	Õ
Oa	Oa
Oc	Oc
Oe	Oe
Of	Ò
Oi	Oi
Oj	Ọ
Om	Om
On	On
Oo	Ô
Op	Op
Or	Ỏ
Os	Ó
Ot	Ot
Ow	Ơ
Ox	Õ
QU	QU
Qu	Qu
UA	UA
UC	UC
UF	Ù
UI	UI
UJ	Ụ
UM	UM
UN	UN
UO	UO
UP	UP
UR	Ủ
US	Ú
UT	UT
UW	Ư
UX	Ũ
UY	UY
Ua	Ua
Uc	Uc
Uf	Ù
Ui	Ui
Uj	Ụ
Um	Um
Un	Un
Uo	Uo
Up	Up
Ur	Ủ
Us	Ú
Ut	Ut
Uw	Ư
Ux	Ũ
Uy	Uy
WO	WO
Wo	Wo
YE	YE
YF	Ỳ
YJ	Ỵ
YR	Ỷ
YS	Ý
YT	YT
YX	Ỹ
Ye	Ye
Yf	Ỳ
Yj	Ỵ
Yr	Ỷ
Ys	Ý
Yt	Yt
Yx	Ỹ
aa	â
ac	ac
af	à
ai	ai
aj	ạ
am	am
an	an
ao	ao
ap	ap
ar	ả
as	á
at	at
au	au
aw	ă
ax	ã
ay	ay
dd	đ
ec	ec
ee	ê
ef	è
ej	ẹ
em	em
en	en
eo	eo
ep	ep
er	ẻ
es	é
et	et
ex	ẽ
gi	gi
ia	ia
ic	ic
ie	ie
if	ì
ij	ị
im	im
in	in
ip	ip
ir	ỉ
is	í
it	it
iu	iu
ix	ĩ
oa	oa
oc	oc
oe	oe
of	ò
oi	oi
oj	ọ
om	om
on	on
oo	ô
op	op
or	ỏ
os	ó
ot	ot
ow	ơ
ox	õ
qu	qu
ua	ua
uc	uc
uf	ù
ui	ui
uj	ụ
um	um
un	un
uo	uo
up	up
ur	ủ
us	ú
ut	ut
uw	ư
ux	ũ
uy	uy
wo	wo
ww	ww
ye	ye
yf	ỳ
yj	ỵ
yr	ỷ
ys	ý
yt	yt
yx	ỹ
AAA	AA
AAC	AAC
AAF	Ầ
AAJ	Ậ
AAM	ÂM
AAN	ÂN
AAP	AAP
AAR	Ẩ
AAS	Ấ
AAT	AAT
AAU	ÂU
AAX	Ẫ
AAY	ÂY
ACF	ÀC
ACH	ACH
ACJ	ẠC
ACR	ẢC
ACS	ÁC
ACX	ÃC
AFF	AF
AIF	ÀI
AIJ	ẠI
AIR	ẢI
AIS	ÁI
AIX	ÃI
AJJ	AJ
AMF	ÀM
AMJ	ẠM
AMR	ẢM
AMS	ÁM
AMX	ÃM
ANF	ÀN
ANG	ANG
ANH	ANH
ANJ	ẠN
ANR	ẢN
ANS	ÁN
ANX	ÃN
AOF	ÀO
AOJ	ẠO
AOR	ẢO
AOS	ÁO
AOX	ÃO
APF	ÀP
APJ	ẠP
APR	ẢP
APS	ÁP
APX	ÃP
ARR	AR
ASS	AS
ATF	ÀT
ATJ	ẠT
ATR	ẢT
ATS	ÁT
ATX	ÃT
AUF	ÀU
AUJ	ẠU
AUR	ẢU
AUS	ÁU
AUX	ÃU
AWC	AWC
AWF	Ằ
AWJ	Ặ
AWM	ĂM
AWN	ĂN
AWP	AWP
AWR	Ẳ
AWS	Ắ
AWT	AWT
AWW	AW
AWX	Ẵ
AXX	AX
AYF	ÀY
AYJ	ẠY
AYR	ẢY
AYS	ÁY
AYX	ÃY
Aaa	Aa
Aac	Aac
Aaf	Ầ
Aaj	Ậ
Aam	Âm
Aan	Ân
Aap	Aap
Aar	Ẩ
Aas	Ấ
Aat	Aat
Aau	Âu
Aax	Ẫ
Aay	Ây
Acf	Àc
Ach	Ach
Acj	Ạc
Acr	Ảc
Acs	Ác
Acx	Ãc
Aff	Af
Aif	Ài
Aij	Ại
Air	Ải
Ais	Ái
Aix	Ãi
Ajj	Aj
Amf	Àm
Amj	Ạm
Amr	Ảm
Ams	Ám
Amx	Ãm
Anf	Àn
Ang	Ang
Anh	Anh
Anj	Ạn
Anr	Ản
Ans	Án
Anx	Ãn
Aof	Ào
Aoj	Ạo
Aor	Ảo
Aos	Áo
Aox	Ão
Apf	Àp
Apj	Ạp
Apr	Ảp
Aps	Áp
Apx	Ãp
Arr	Ar
Ass	As
Atf	Àt
Atj	Ạt
Atr	Ảt
Ats	Át
Atx	Ãt
Auf	Àu
Auj	Ạu
Aur	Ảu
Aus	Áu
Aux	Ãu
Awc	Awc
Awf	Ằ
Awj	Ặ
Awm	Ăm
Awn	Ăn
Awp	Awp
Awr	Ẳ
Aws	Ắ
Awt	Awt
Aww	Aw
Awx	Ẵ
Axx	Ax
Ayf	Ày
Ayj	Ạy
Ayr	Ảy
Ays	Áy
Ayx	Ãy
DDD	DD
Ddd	Dd
ECF	ÈC
ECJ	ẸC
ECR	ẺC
ECS	ÉC
ECX	ẼC
EEC	EEC
EEE	EE
EEF	Ề
EEJ	Ệ
EEM	ÊM
EEN	ÊN
EEP	EEP
EER	Ể
EES	Ế
EET	EET
EEU	ÊU
EEX	Ễ
EFF	EF
EJJ	EJ
EMF	ÈM
EMJ	ẸM
EMR	ẺM
EMS	ÉM
EMX	ẼM
ENF	ÈN
ENG	ENG
ENJ	ẸN
ENR	ẺN
ENS	ÉN
ENX	ẼN
EOF	ÈO
EOJ	ẸO
EOR	ẺO
EOS	ÉO
EOX	ẼO
EPF	ÈP
EPJ	ẸP
EPR	ẺP
EPS	ÉP
EPX	ẼP
ERR	ER
ESS	ES
ETF	ÈT
ETJ	ẸT
ETR	ẺT
ETS	ÉT
ETX	ẼT
EXX	EX
Ecf	Èc
Ecj	Ẹc
Ecr	Ẻc
Ecs	Éc
Ecx	Ẽc
Eec	Eec
Eee	Ee
Eef	Ề
Eej	Ệ
Eem	Êm
Een	Ên
Eep	Eep
Eer	Ể
Ees	Ế
Eet	Eet
Eeu	Êu
Eex	Ễ
Eff	Ef
Ejj	Ej
Emf	Èm
Emj	Ẹm
Emr	Ẻm
Ems	Ém
Emx	Ẽm
Enf	Èn
Eng	Eng
Enj	Ẹn
Enr	Ẻn
Ens	Én
Enx	Ẽn
Eof	Èo
Eoj	Ẹo
Eor	Ẻo
Eos	Éo
Eox	Ẽo
Epf	Èp
Epj	Ẹp
Epr	Ẻp
Eps	Ép
Epx	Ẽp
Err	Er
Ess	Es
Etf	Èt
Etj	Ẹt
Etr	Ẻt
Ets	Ét
Etx	Ẽt
Exx	Ex
GIF	GÌ
GIR	GỈ
Gif	Gì
Gir	Gỉ
IAF	ÌA
IAJ	ỊA
IAR	ỈA
IAS	ÍA
IAX	ĨA
ICH	ICH
ICJ	ICJ
ICS	ÍC
IEE	IEE
IFF	IF
IMF	ÌM
IMJ	ỊM
IMR	ỈM
IMS	ÍM
IMX	ĨM
INF	ÌN
INH	INH
INJ	ỊN
INR	ỈN
INS	ÍN
INX	ĨN
IPJ	ỊP
IPS	ÍP
IRR	IR
ISS	IS
ITJ	ỊT
ITS	ÍT
IUF	ÌU
IUJ	ỊU
IUR	ỈU
IUS	ÍU
IUX	ĨU
IXX	IX
Iaf	Ìa
Iaj	Ịa
Iar	Ỉa
Ias	Ía
Iax	Ĩa
Ich	Ich
Icj	Icj
Ics	Íc
Iee	Iee
Iff	If
Imf	Ìm
Imj	Ịm
Imr	Ỉm
Ims	Ím
Imx	Ĩm
Inf	Ìn
Inh	Inh
Inj	Ịn
Inr	Ỉn
Ins	Ín
Inx	Ĩn
Ipj	Ịp
Ips	Íp
Irr	Ir
Iss	Is
Itj	Ịt
Its	Ít
Iuf	Ìu
Iuj	Ịu
Iur	Ỉu
Ius	Íu
Iux	Ĩu
Ixx	Ix
OAC	OAC
OAF	OÀ
OAI	OAI
OAJ	OẠ
OAM	OAM
OAN	OAN
OAR	OẢ
OAS	OÁ
OAT	OAT
OAW	OAW
OAX	OÃ
OCF	ÒC
OCJ	ỌC
OCR	ỎC
OCS	ÓC
OCX	ÕC
OEF	OÈ
OEJ	OẸ
OER	OẺ
OES	OÉ
OET	OET
OEX	OẼ
OFF	OF
OIF	ÒI
OIJ	ỌI
OIR	ỎI
OIS	ÓI
OIX	ÕI
OJJ	OJ
OMF	ÒM
OMJ	ỌM
OMR	ỎM
OMS	ÓM
OMX	ÕM
ONF	ÒN
ONG	ONG
ONJ	ỌN
ONR	ỎN
ONS	ÓN
ONX	ÕN
OOC	ÔC
OOF	Ồ
OOI	ÔI
OOJ	Ộ
OOM	ÔM
OON	ÔN
OOO	OO
OOP	ÔP
OOR	Ổ
OOS	Ố
OOT	ÔT
OOX	Ỗ
OPF	ÒP
OPJ	ỌP
OPR	ỎP
OPS	ÓP
OPX	ÕP
ORR	OR
OSS	OS
OTF	ÒT
OTJ	ỌT
OTR	ỎT
OTS	ÓT
OTX	ÕT
OWF	Ờ
OWI	ƠI
OWJ	Ợ
OWM	ƠM
OWN	ƠN
OWP	ƠP
OWR	Ở
OWS	Ớ
OWT	ƠT
OWW	OW
OWX	Ỡ
OXX	OX
Oac	Oac
Oaf	Oà
Oai	Oai
Oaj	Oạ
Oan	Oan
Oar	Oả
Oas	Oá
Oat	Oat
Oaw	Oaw
Oax	Oã
Ocf	Òc
Ocj	Ọc
Ocr	Ỏc
Ocs	Óc
Ocx	Õc
Oef	Oè
Oej	Oẹ
Oer	Oẻ
Oes	Oé
Oet	Oet
Oex	Oẽ
Off	Of
Oif	Òi
Oij	Ọi
Oir	Ỏi
Ois	Ói
Oix	Õi
Ojj	Oj
Omf	Òm
Omj	Ọm
Omr	Ỏm
Oms	Óm
Omx	Õm
Onf	Òn
Ong	Ong
Onj	Ọn
Onr	Ỏn
Ons	Ón
Onx	Õn
Ooc	Ôc
Oof	Ồ
Ooi	Ôi
Ooj	Ộ
Oom	Ôm
Oon	Ôn
Ooo	Oo
Oop	Ôp
Oor	Ổ
Oos	Ố
Oot	Ôt
Oox	Ỗ
Opf	Òp
Opj	Ọp
Opr	Ỏp
Ops	Óp
Opx	Õp
Orr	Or
Oss	Os
Otf	Òt
Otj	Ọt
Otr	Ỏt
Ots	Ót
Otx	Õt
Owf	Ờ
Owi	Ơi
Owj	Ợ
Owm	Ơm
Own	Ơn
Owp	Ơp
Owr	Ở
Ows	Ớ
Owt	Ơt
Oww	Ow
Owx	Ỡ
Oxx	Ox
UAF	ÙA
UAJ	ỤA
UAR	ỦA
UAS	ÚA
UAX	ŨA
UCJ	ỤC
UCS	ÚC
UFF	UF
UIF	ÙI
UIJ	ỤI
UIR	ỦI
UIS	ÚI
UIX	ŨI
UJJ	UJ
UMF	ÙM
UMJ	ỤM
UMR	ỦM
UMS	ÚM
UMX	ŨM
UNF	ÙN
UNG	UNG
UNJ	ỤN
UNR	ỦN
UNS	ÚN
UNX	ŨN
UOO	UOO
UOW	UOW
UPJ	ỤP
UPS	ÚP
URR	UR
USS	US
UTJ	ỤT
UTS	ÚT
UWA	ƯA
UWC	ƯC
UWF	Ừ
UWI	ƯI
UWJ	Ự
UWN	ƯN
UWO	UWO
UWR	Ử
UWS	Ứ
UWT	UWT
UWU	ƯU
UWW	UW
UWX	Ữ
UXX	UX
UYF	UỲ
UYJ	UỴ
UYR	UỶ
UYS	UÝ
UYT	UYT
UYX	UỸ
Uaf	Ùa
Uaj	Ụa
Uar	Ủa
Uas	Úa
Uax	Ũa
Ucj	Ục
Ucs	Úc
Uff	Uf
Uif	Ùi
Uij	Ụi
Uir	Ủi
Uis	Úi
Uix	Ũi
Ujj	Uj
Umf	Ùm
Umj	Ụm
Umr	Ủm
Ums	Úm
Umx	Ũm
Unf	Ùn
Ung	Ung
Unj	Ụn
Unr	Ủn
Uns	Ún
Unx	Ũn
Uoo	Uoo
Uow	Uow
Upj	Ụp
Ups	Úp
Urr	Ur
Uss	Us
Utj	Ụt
Uts	Út
Uwa	Ưa
Uwc	Ưc
Uwf	Ừ
Uwi	Ưi
Uwj	Ự
Uwn	Ưn
Uwo	Uwo
Uwr	Ử
Uws	Ứ
Uwt	Uwt
Uwu	Ưu
Uww	Uw
Uwx	Ữ
Uxx	Ux
Uyf	Uỳ
Uyj	Uỵ
Uyr	Uỷ
Uys	Uý
Uyt	Uyt
Uyx	Uỹ
WOW	WOW
WWA	WA
WWa	Wa
Wow	Wow
Wwa	Wa
YEE	YEE
YNH	YNH
YSS	YS
YTS	ÝT
Yee	Yee
Ynh	Ynh
Yss	Ys
Yts	Ýt
aaa	aa
aac	aac
aaf	ầ
aaj	ậ
aam	âm
aan	ân
aap	aap
aar	ẩ
aas	ấ
aat	aat
aau	âu
aax	ẫ
aay	ây
acf	àc
ach	ach
acj	ạc
acr	ảc
acs	ác
acx	ãc
aff	af
aif	ài
aij	ại
air	ải
ais	ái
aix	ãi
ajj	aj
amf	àm
amj	ạm
amr	ảm
ams	ám
amx	ãm
anf	àn
ang	ang
anh	anh
anj	ạn
anr	ản
ans	án
anx	ãn
aof	ào
aoj	ạo
aor	ảo
aos	áo
aox	ão
apf	àp
apj	ạp
apr	ảp
aps	áp
apx	ãp
arr	ar
ass	as
atf	àt
atj	ạt
atr	ảt
ats	át
atx	ãt
auf	àu
auj	ạu
aur	ảu
aus	áu
aux	ãu
awc	awc
awf	ằ
awj	ặ
awm	ăm
awn	ăn
awp	awp
awr	ẳ
aws	ắ
awt	awt
aww	aw
awx	ẵ
axx	ax
ayf	ày
ayj	ạy
ayr	ảy
ays	áy
ayx	ãy
ddd	dd
ecf	èc
ecj	ẹc
ecr	ẻc
ecs	éc
ecx	ẽc
eec	eec
eee	ee
eef	ề
eej	ệ
eem	êm
een	ên
eep	eep
eer	ể
ees	ế
eet	eet
eeu	êu
eex	ễ
eff	ef
ejj	ej
emf	èm
emj	ẹm
emr	ẻm
ems	ém
emx	ẽm
enf	èn
eng	eng
enj	ẹn
enr	ẻn
ens	én
enx	ẽn
eof	èo
eoj	ẹo
eor	ẻo
eos	éo
eox	ẽo
epf	èp
epj	ẹp
epr	ẻp
eps	ép
epx	ẽp
err	er
ess	es
etf	èt
etj	ẹt
etr	ẻt
ets	ét
etx	ẽt
exx	ex
gif	gì
gir	gỉ
iaf	ìa
iaj	ịa
iar	ỉa
ias	ía
iax	ĩa
ich	ich
icj	icj
ics	íc
iee	iee
iff	if
imf	ìm
imj	ịm
imr	ỉm
ims	ím
imx	ĩm
inf	ìn
inh	inh
inj	ịn
inr	ỉn
ins	ín
inx	ĩn
ipj	ịp
ips	íp
irr	ir
iss	is
itj	ịt
its	ít
iuf	ìu
iuj	ịu
iur	ỉu
ius	íu
iux	ĩu
ixx	ix
oac	oac
oaf	oà
oai	oai
oaj	oạ
oam	oam
oan	oan
oar	oả
oas	oá
oat	oat
oaw	oaw
oax	oã
ocf	òc
ocj	ọc
ocr	ỏc
ocs	óc
ocx	õc
oef	oè
oej	oẹ
oer	oẻ
oes	oé
oet	oet
oex	oẽ
off	of
oif	òi
oij	ọi
oir	ỏi
ois	ói
oix	õi
ojj	oj
omf	òm
omj	ọm
omr	ỏm
oms	óm
omx	õm
onf	òn
ong	ong
onj	ọn
onr	ỏn
ons	ón
onx	õn
ooc	ôc
oof	ồ
ooi	ôi
ooj	ộ
oom	ôm
oon	ôn
ooo	oo
oop	ôp
oor	ổ
oos	ố
oot	ôt
oox	ỗ
opf	òp
opj	ọp
opr	ỏp
ops	óp
opx	õp
orr	or
oss	os
otf	òt
otj	ọt
otr	ỏt
ots	ót
otx	õt
owf	ờ
owi	ơi
owj	ợ
owm	ơm
own	ơn
owp	ơp
owr	ở
ows	ớ
owt	ơt
oww	ow
owx	ỡ
oxx	ox
uaf	ùa
uaj	ụa
uar	ủa
uas	úa
uax	ũa
ucj	ục
ucs	úc
uff	uf
uif	ùi
uij	ụi
uir	ủi
uis	úi
uix	ũi
ujj	uj
umf	ùm
umj	ụm
umr	ủm
ums	úm
umx	ũm
unf	ùn
ung	ung
unj	ụn
unr	ủn
uns	ún
unx	ũn
uoo	uoo
uow	uow
upj	ụp
ups	úp
urr	ur
uss	us
utj	ụt
uts	út
uwa	ưa
uwc	ưc
uwf	ừ
uwi	ưi
uwj	ự
uwn	ưn
uwo	uwo
uwr	ử
uws	ứ
uwt	uwt
uwu	ưu
uww	uw
uwx	ữ
uxx	ux
uyf	uỳ
uyj	uỵ
uyr	uỷ
uys	uý
uyt	uyt
uyx	uỹ
wow	wow
wwa	wa
www	www
yee	yee
ynh	ynh
yss	ys
yts	ýt
AACF	ẦC
AACJ	ẬC
AACR	ẨC
AACS	ẤC
AACX	ẪC
AAMF	ẦM
AAMJ	ẬM
AAMR	ẨM
AAMS	ẤM
AAMX	ẪM
AANF	ẦN
AANG	ÂNG
AANJ	ẬN
AANR	ẨN
AANS	ẤN
AANX	ẪN
AAPF	ẦP
AAPJ	ẬP
AAPR	ẨP
AAPS	ẤP
AAPX	ẪP
AATF	ẦT
AATJ	ẬT
AATR	ẨT
AATS	ẤT
AATX	ẪT
AAUF	ẦU
AAUJ	ẬU
AAUR	ẨU
AAUS	ẤU
AAUX	ẪU
AAYF	ẦY
AAYJ	ẬY
AAYR	ẨY
AAYS	ẤY
AAYX	ẪY
ACHF	ÀCH
ACHJ	ẠCH
ACHR	ẢCH
ACHS	ÁCH
ACJJ	ACJ
ACRR	ACR
AIXX	AIX
AMSS	AMS
ANGF	ÀNG
ANGJ	ẠNG
ANGR	ẢNG
ANGS	ÁNG
ANGX	ÃNG
ANHF	ÀNH
ANHJ	ẠNH
ANHR	ẢNH
ANHS	ÁNH
ANHX	ÃNH
ANSS	ANS
APSS	APS
ATRR	ATR
ATXX	ATX
AURR	AUR
AUSS	AUS
AUXX	AUX
AWCF	ẰC
AWCJ	ẶC
AWCR	ẲC
AWCS	ẮC
AWCX	ẴC
AWMF	ẰM
AWMJ	ẶM
AWMR	ẲM
AWMS	ẮM
AWMX	ẴM
AWNF	ẰN
AWNG	ĂNG
AWNJ	ẶN
AWNR	ẲN
AWNS	ẮN
AWNX	ẴN
AWPF	ẰP
AWPJ	ẶP
AWPR	ẲP
AWPS	ẮP
AWPX	ẴP
AWTF	ẰT
AWTJ	ẶT
AWTR	ẲT
AWTS	ẮT
AWTX	ẴT
Aacf	Ầc
Aacj	Ậc
Aacr	Ẩc
Aacs	Ấc
Aacx	Ẫc
Aamf	Ầm
Aamj	Ậm
Aamr	Ẩm
Aams	Ấm
Aamx	Ẫm
Aanf	Ần
Aang	Âng
Aanj	Ận
Aanr	Ẩn
Aans	Ấn
Aanx	Ẫn
Aapf	Ầp
Aapj	Ập
Aapr	Ẩp
Aaps	Ấp
Aapx	Ẫp
Aatf	Ầt
Aatj	Ật
Aatr	Ẩt
Aats	Ất
Aatx	Ẫt
Aauf	Ầu
Aauj	Ậu
Aaur	Ẩu
Aaus	Ấu
Aaux	Ẫu
Aayf	Ầy
Aayj	Ậy
Aayr	Ẩy
Aays	Ấy
Aayx	Ẫy
Achf	Àch
Achj	Ạch
Achr	Ảch
Achs	Ách
Achx	Ãch
Acjj	Acj
Acrr	Acr
Aixx	Aix
Amss	Ams
Angf	Àng
Angj	Ạng
Angr	Ảng
Angs	Áng
Angx	Ãng
Anhf	Ành
Anhj	Ạnh
Anhr	Ảnh
Anhs	Ánh
Anhx	Ãnh
Anss	Ans
Apss	Aps
Atrr	Atr
Atxx	Atx
Aurr	Aur
Auss	Aus
Auxx	Aux
Awcf	Ằc
Awcj	Ặc
Awcr	Ẳc
Awcs	Ắc
Awcx	Ẵc
Awmf	Ằm
Awmj	Ặm
Awmr	Ẳm
Awms	Ắm
Awmx	Ẵm
Awnf	Ằn
Awng	Ăng
Awnj	Ặn
Awnr	Ẳn
Awns	Ắn
Awnx	Ẵn
Awpf	Ằp
Awpj	Ặp
Awpr	Ẳp
Awps	Ắp
Awpx	Ẵp
Awtf	Ằt
Awtj	Ặt
Awtr	Ẳt
Awts	Ắt
Awtx	Ẵt
ECFF	ECF
ECRR	ECR
ECSS	ECS
EECH	EECH
EECJ	ỆC
EEMF	ỀM
EEMJ	ỆM
EEMR	ỂM
EEMS	ẾM
EEMX	ỄM
EENF	ỀN
EENG	ÊNG
EENH	ÊNH
EENJ	ỆN
EENR	ỂN
EENS	ẾN
EENX	ỄN
EEPF	ỀP
EEPJ	ỆP
EEPR	ỂP
EEPS	ẾP
EEPX	ỄP
EERR	EER
EESS	EES
EETJ	ỆT
EETR	ỂT
EETS	ẾT
EETX	ỄT
EEUF	ỀU
EEUJ	ỆU
EEUR	ỂU
EEUS	ẾU
EEUX	ỄU
EMSS	EMS
ENGS	ÉNG
ENSS	ENS
EPSS	EPS
ETFF	ETF
ETRR	ETR
ETSS	ETS
Ecff	Ecf
Ecrr	Ecr
Ecss	Ecs
Eech	Eech
Eecj	Ệc
Eemf	Ềm
Eemj	Ệm
Eemr	Ểm
Eems	Ếm
Eemx	Ễm
Eenf	Ền
Eeng	Êng
Eenh	Ênh
Eenj	Ện
Eenr	Ển
Eens	Ến
Eenx	Ễn
Eepf	Ềp
Eepj	Ệp
Eepr	Ểp
Eeps	Ếp
Eepx	Ễp
Eerr	Eer
Eess	Ees
Eetj	Ệt
Eetr	Ểt
Eets	Ết
Eetx	Ễt
Eeuf	Ều
Eeuj	Ệu
Eeur	Ểu
Eeus	Ếu
Eeux	Ễu
Emss	Ems
Engs	Éng
Enss	Ens
Epss	Eps
Etff	Etf
Etrr	Etr
Etss	Ets
GIFF	GIF
GIRR	GIR
Giff	Gif
Girr	Gir
IAFF	IAF
IARR	IAR
IASS	IAS
IAXX	IAX
ICHJ	ỊCH
ICHS	ÍCH
ICJH	ỊCH
ICJJ	ICJ
ICSS	ICS
IEEC	IÊC
IEEF	IỀ
IEEJ	IỆ
IEEM	IÊM
IEEN	IÊN
IEEP	IÊP
IEER	IỂ
IEES	IẾ
IEET	IEET
IEEU	IÊU
IEEX	IỄ
IMFF	IMF
IMRR	IMR
IMXX	IMX
INFF	INF
INHF	ÌNH
INHJ	ỊNH
INHR	ỈNH
INHS	ÍNH
INHX	ĨNH
INJJ	INJ
INRR	INR
INSS	INS
INXX	INX
IPJJ	IPJ
IPSS	IPS
ITJJ	ITJ
ITSS	ITS
IUFF	IUF
IUJJ	IUJ
IURR	IUR
IUXX	IUX
Iaff	Iaf
Iarr	Iar
Iass	Ias
Iaxx	Iax
Ichj	Ịch
Ichs	Ích
Icjh	Ịch
Icjj	Icj
Icss	Ics
Ieec	Iêc
Ieef	Iề
Ieej	Iệ
Ieem	Iêm
Ieen	Iên
Ieep	Iêp
Ieer	Iể
Iees	Iế
Ieet	Ieet
Ieeu	Iêu
Ieex	Iễ
Imff	Imf
Imrr	Imr
Imxx	Imx
Inff	Inf
Inhf	Ình
Inhj	Ịnh
Inhr	Ỉnh
Inhs	Ính
Inhx	Ĩnh
Injj	Inj
Inrr	Inr
Inss	Ins
Inxx	Inx
Ipjj	Ipj
Ipss	Ips
Itjj	Itj
Itss	Its
Iuff	Iuf
Iujj	Iuj
Iurr	Iur
Iuxx	Iux
OACF	OÀC
OACH	OACH
OACJ	OẠC
OACR	OẢC
OACS	OÁC
OACX	OÃC
OAIF	OÀI
OAIJ	OẠI
OAIR	OẢI
OAIS	OÁI
OAIX	OÃI
OAMJ	OẠM
OANF	OÀN
OANG	OANG
OANH	OANH
OANJ	OẠN
OANR	OẢN
OANS	OÁN
OANX	OÃN
OASS	OAS
OATF	OÀT
OATJ	OẠT
OATR	OẢT
OATS	OÁT
OATX	OÃT
OAWC	OAWC
OAWF	OẰ
OAWJ	OẶ
OAWN	OĂN
OAWR	OẲ
OAWS	OẮ
OAWT	OĂT
OAWX	OẴ
OEFF	OEF
OERR	OER
OETJ	OẸT
OETS	OÉT
OISS	OIS
OMFF	OMF
OMSS	OMS
ONFF	ONF
ONGF	ÒNG
ONGJ	ỌNG
ONGR	ỎNG
ONGS	ÓNG
ONGX	ÕNG
ONSS	ONS
OOCF	ỒC
OOCJ	ỘC
OOCR	ỔC
OOCS	ỐC
OOCX	ỖC
OOIF	ỒI
OOIJ	ỘI
OOIR	ỔI
OOIS	ỐI
OOIX	ỖI
OOMF	ỒM
OOMJ	ỘM
OOMR	ỔM
OOMS	ỐM
OOMX	ỖM
OONF	ỒN
OONG	ÔNG
OONJ	ỘN
OONR	ỔN
OONS	ỐN
OONX	ỖN
OOOF	OÒ
OOOJ	OỌ
OOOR	OỎ
OOOS	OÓ
OOOX	OÕ
OOPF	ỒP
OOPJ	ỘP
OOPR	ỔP
OOPS	ỐP
OOPX	ỖP
OOTF	ỒT
OOTJ	ỘT
OOTR	ỔT
OOTS	ỐT
OOTX	ỖT
OPFF	OPF
OPSS	OPS
OTFF	OTF
OTSS	OTS
OWFF	OWF
OWIF	ỜI
OWIJ	ỢI
OWIR	ỞI
OWIS	ỚI
OWIX	ỠI
OWJJ	OWJ
OWMF	ỜM
OWMJ	ỢM
OWMR	ỞM
OWMS	ỚM
OWMX	ỠM
OWNF	ỜN
OWNJ	ỢN
OWNR	ỞN
OWNS	ỚN
OWNX	ỠN
OWPF	ỜP
OWPJ	ỢP
OWPR	ỞP
OWPS	ỚP
OWPX	ỠP
OWRR	OWR
OWSS	OWS
OWTF	ỜT
OWTJ	ỢT
OWTR	ỞT
OWTS	ỚT
OWTX	ỠT
OWXX	OWX
Oacf	Oàc
Oach	Oach
Oacj	Oạc
Oacr	Oảc
Oacs	Oác
Oacx	Oãc
Oaif	Oài
Oaij	Oại
Oair	Oải
Oais	Oái
Oaix	Oãi
Oanf	Oàn
Oang	Oang
Oanh	Oanh
Oanj	Oạn
Oanr	Oản
Oans	Oán
Oanx	Oãn
Oass	Oas
Oatf	Oàt
Oatj	Oạt
Oatr	Oảt
Oats	Oát
Oatx	Oãt
Oawc	Oawc
Oawf	Oằ
Oawj	Oặ
Oawn	Oăn
Oawr	Oẳ
Oaws	Oắ
Oawt	Oăt
Oawx	Oẵ
Oeff	Oef
Oerr	Oer
Oetj	Oẹt
Oets	Oét
Oiss	Ois
Omff	Omf
Omss	Oms
Onff	Onf
Ongf	Òng
Ongj	Ọng
Ongr	Ỏng
Ongs	Óng
Ongx	Õng
Onss	Ons
Oocf	Ồc
Oocj	Ộc
Oocr	Ổc
Oocs	Ốc
Oocx	Ỗc
Ooif	Ồi
Ooij	Ội
Ooir	Ổi
Oois	Ối
Ooix	Ỗi
Oomf	Ồm
Oomj	Ộm
Oomr	Ổm
Ooms	Ốm
Oomx	Ỗm
Oonf	Ồn
Oong	Ông
Oonj	Ộn
Oonr	Ổn
Oons	Ốn
Oonx	Ỗn
Ooof	Oò
Oooj	Oọ
Ooor	Oỏ
Ooos	Oó
Ooox	Oõ
Oopf	Ồp
Oopj	Ộp
Oopr	Ổp
Oops	Ốp
Oopx	Ỗp
Ootf	Ồt
Ootj	Ột
Ootr	Ổt
Oots	Ốt
Ootx	Ỗt
Opff	Opf
Opss	Ops
Otff	Otf
Otss	Ots
Owff	Owf
Owif	Ời
Owij	Ợi
Owir	Ởi
Owis	Ới
Owix	Ỡi
Owjj	Owj
Owmf	Ờm
Owmj	Ợm
Owmr	Ởm
Owms	Ớm
Owmx	Ỡm
Ownf	Ờn
Ownj	Ợn
Ownr	Ởn
Owns	Ớn
Ownx	Ỡn
Owpf	Ờp
Owpj	Ợp
Owpr	Ởp
Owps	Ớp
Owpx	Ỡp
Owrr	Owr
Owss	Ows
Owtf	Ờt
Owtj	Ợt
Owtr	Ởt
Owts	Ớt
Owtx	Ỡt
Owxx	Owx
UAAN	UÂN
UAAT	UÂT
UAFF	UAF
UAXX	UAX
UIFF	UIF
UMFF	UMF
UMJJ	UMJ
UMRR	UMR
UMXX	UMX
UNFF	UNF
UNGF	ÙNG
UNGJ	ỤNG
UNGR	ỦNG
UNGS	ÚNG
UNGX	ŨNG
UNJJ	UNJ
UNRR	UNR
UNXX	UNX
UOOC	UÔC
UOOI	UÔI
UOOM	UÔM
UOON	UÔN
UOOS	UỐ
UOOT	UÔT
UOWC	ƯƠC
UOWF	ƯỜ
UOWI	ƯƠI
UOWJ	ƯỢ
UOWM	ƯƠM
UOWN	ƯƠN
UOWP	ƯƠP
UOWR	ƯỞ
UOWS	ƯỚ
UOWT	ƯƠT
UOWX	ƯỠ
UWAF	ỪA
UWAJ	ỰA
UWAR	ỬA
UWAS	ỨA
UWAX	ỮA
UWCJ	ỰC
UWCS	ỨC
UWIR	ỬI
UWNG	ƯNG
UWNX	ỮN
UWOW	UWOW
UWTS	ỨT
UWUF	ỪU
UWUJ	ỰU
UWUR	ỬU
UWUS	ỨU
UWUX	ỮU
UYCH	UYCH
UYEE	UYEE
UYNH	UYNH
UYTJ	UỴT
UYTS	UÝT
Uaan	Uân
Uaat	Uât
Uaff	Uaf
Uaxx	Uax
Uiff	Uif
Umff	Umf
Umjj	Umj
Umrr	Umr
Umxx	Umx
Unff	Unf
Ungf	Ùng
Ungj	Ụng
Ungr	Ủng
Ungs	Úng
Ungx	Ũng
Unjj	Unj
Unrr	Unr
Unxx	Unx
Uooc	Uôc
Uooi	Uôi
Uoom	Uôm
Uoon	Uôn
Uoos	Uố
Uoot	Uôt
Uowc	Ươc
Uowf	Ườ
Uowi	Ươi
Uowj	Ượ
Uowm	Ươm
Uown	Ươn
Uowp	Ươp
Uowr	Ưở
Uows	Ướ
Uowt	Ươt
Uowx	Ưỡ
Uwaf	Ừa
Uwaj	Ựa
Uwar	Ửa
Uwas	Ứa
Uwax	Ữa
Uwcj	Ực
Uwcs	Ức
Uwir	Ửi
Uwng	Ưng
Uwnx	Ữn
Uwow	Uwow
Uwts	Ứt
Uwuf	Ừu
Uwuj	Ựu
Uwur	Ửu
Uwus	Ứu
Uwux	Ữu
Uych	Uych
Uyee	Uyee
Uynh	Uynh
Uytj	Uỵt
Uyts	Uýt
WOWC	ƯƠC
WOWF	ƯỜ
WOWI	ƯƠI
WOWJ	ƯỢ
WOWM	ƯƠM
WOWN	ƯƠN
WOWP	ƯƠP
WOWR	ƯỞ
WOWS	ƯỚ
WOWT	ƯƠT
WOWX	ƯỠ
Wowc	Ươc
Wowf	Ườ
Wowi	Ươi
Wowj	Ượ
Wowm	Ươm
Wown	Ươn
Wowp	Ươp
Wowr	Ưở
Wows	Ướ
Wowt	Ươt
Wowx	Ưỡ
YEEF	YỀ
YEEM	YÊM
YEEN	YÊN
YEES	YẾ
YEET	YÊT
YEEU	YÊU
YNHF	ỲNH
YNHS	ÝNH
Yeef	Yề
Yeem	Yêm
Yeen	Yên
Yees	Yế
Yeet	Yêt
Yeeu	Yêu
Ynhf	Ỳnh
Ynhs	Ýnh
aacf	ầc
aacj	ậc
aacr	ẩc
aacs	ấc
aacx	ẫc
aamf	ầm
aamj	ậm
aamr	ẩm
aams	ấm
aamx	ẫm
aanf	ần
aang	âng
aanj	ận
aanr	ẩn
aans	ấn
aanx	ẫn
aapf	ầp
aapj	ập
aapr	ẩp
aaps	ấp
aapx	ẫp
aatf	ầt
aatj	ật
aatr	ẩt
aats	ất
aatx	ẫt
aauf	ầu
aauj	ậu
aaur	ẩu
aaus	ấu
aaux	ẫu
aayf	ầy
aayj	ậy
aayr	ẩy
aays	ấy
aayx	ẫy
achf	àch
achj	ạch
achr	ảch
achs	ách
acjj	acj
acrr	acr
aixx	aix
amss	ams
angf	àng
angj	ạng
angr	ảng
angs	áng
angx	ãng
anhf	ành
anhj	ạnh
anhr	ảnh
anhs	ánh
anhx	ãnh
anss	ans
apss	aps
atrr	atr
atxx	atx
aurr	aur
auss	aus
auxx	aux
awcf	ằc
awcj	ặc
awcr	ẳc
awcs	ắc
awcx	ẵc
awmf	ằm
awmj	ặm
awmr	ẳm
awms	ắm
awmx	ẵm
awnf	ằn
awng	ăng
awnj	ặn
awnr	ẳn
awns	ắn
awnx	ẵn
awpf	ằp
awpj	ặp
awpr	ẳp
awps	ắp
awpx	ẵp
awtf	ằt
awtj	ặt
awtr	ẳt
awts	ắt
awtx	ẵt
ecff	ecf
ecrr	ecr
ecss	ecs
eech	eech
eecj	ệc
eemf	ềm
eemj	ệm
eemr	ểm
eems	ếm
eemx	ễm
eenf	ền
eeng	êng
eenh	ênh
eenj	ện
eenr	ển
eens	ến
eenx	ễn
eepf	ềp
eepj	ệp
eepr	ểp
eeps	ếp
eepx	ễp
eerr	eer
eess	ees
eetj	ệt
eetr	ểt
eets	ết
eetx	ễt
eeuf	ều
eeuj	ệu
eeur	ểu
eeus	ếu
eeux	ễu
emss	ems
engf	èng
engr	ẻng
engs	éng
enss	ens
epss	eps
etff	etf
etrr	etr
etss	ets
giff	gif
girr	gir
iaff	iaf
iarr	iar
iass	ias
iaxx	iax
ichj	ịch
ichs	ích
icjh	ịch
icjj	icj
icss	ics
ieec	iêc
ieef	iề
ieej	iệ
ieem	iêm
ieen	iên
ieep	iêp
ieer	iể
iees	iế
ieet	ieet
ieeu	iêu
ieex	iễ
imff	imf
imrr	imr
imxx	imx
inff	inf
inhf	ình
inhj	ịnh
inhr	ỉnh
inhs	ính
inhx	ĩnh
injj	inj
inrr	inr
inss	ins
inxx	inx
ipjj	ipj
ipss	ips
itjj	itj
itss	its
iuff	iuf
iujj	iuj
iurr	iur
iuxx	iux
oacf	oàc
oach	oach
oacj	oạc
oacr	oảc
oacs	oác
oacx	oãc
oaif	oài
oaij	oại
oair	oải
oais	oái
oaix	oãi
oamj	oạm
oanf	oàn
oang	oang
oanh	oanh
oanj	oạn
oanr	oản
oans	oán
oanx	oãn
oass	oas
oatf	oàt
oatj	oạt
oatr	oảt
oats	oát
oatx	oãt
oawc	oawc
oawf	oằ
oawj	oặ
oawn	oăn
oawr	oẳ
oaws	oắ
oawt	oăt
oawx	oẵ
oeff	oef
oerr	oer
oetj	oẹt
oets	oét
oiss	ois
omff	omf
omss	oms
onff	onf
ongf	òng
ongj	ọng
ongr	ỏng
ongs	óng
ongx	õng
onss	ons
oocf	ồc
oocj	ộc
oocr	ổc
oocs	ốc
oocx	ỗc
ooif	ồi
ooij	ội
ooir	ổi
oois	ối
ooix	ỗi
oomf	ồm
oomj	ộm
oomr	ổm
ooms	ốm
oomx	ỗm
oonf	ồn
oong	ông
oonj	ộn
oonr	ổn
oons	ốn
oonx	ỗn
ooof	oò
oooj	oọ
ooor	oỏ
ooos	oó
ooox	oõ
oopf	ồp
oopj	ộp
oopr	ổp
oops	ốp
oopx	ỗp
ootf	ồt
ootj	ột
ootr	ổt
oots	ốt
ootx	ỗt
opff	opf
opss	ops
otff	otf
otss	ots
owff	owf
owif	ời
owij	ợi
owir	ởi
owis	ới
owix	ỡi
owjj	owj
owmf	ờm
owmj	ợm
owmr	ởm
owms	ớm
owmx	ỡm
ownf	ờn
ownj	ợn
ownr	ởn
owns	ớn
ownx	ỡn
owpf	ờp
owpj	ợp
owpr	ởp
owps	ớp
owpx	ỡp
owrr	owr
owss	ows
owtf	ờt
owtj	ợt
owtr	ởt
owts	ớt
owtx	ỡt
owxx	owx
uaan	uân
uaat	uât
uaff	uaf
uaxx	uax
uiff	uif
umff	umf
umjj	umj
umrr	umr
umxx	umx
unff	unf
ungf	ùng
ungj	ụng
ungr	ủng
ungs	úng
ungx	ũng
unjj	unj
unrr	unr
unxx	unx
uooc	uôc
uooi	uôi
uoom	uôm
uoon	uôn
uoos	uố
uoot	uôt
uowc	ươc
uowf	ườ
uowi	ươi
uowj	ượ
uowm	ươm
uown	ươn
uowp	ươp
uowr	ưở
uows	ướ
uowt	ươt
uowx	ưỡ
uwaf	ừa
uwaj	ựa
uwar	ửa
uwas	ứa
uwax	ữa
uwcj	ực
uwcs	ức
uwir	ửi
uwng	ưng
uwnx	ữn
uwow	uwow
uwts	ứt
uwuf	ừu
uwuj	ựu
uwur	ửu
uwus	ứu
uwux	ữu
uych	uych
uyee	uyee
uynh	uynh
uytj	uỵt
uyts	uýt
wowc	ươc
wowf	ườ
wowi	ươi
wowj	ượ
wowm	ươm
wown	ươn
wowp	ươp
wowr	ưở
wows	ướ
wowt	ươt
wowx	ưỡ
yeef	yề
yeem	yêm
yeen	yên
yees	yế
yeet	yêt
yeeu	yêu
ynhf	ỳnh
ynhs	ýnh
AANGF	ẦNG
AANGJ	ẬNG
AANGR	ẨNG
AANGS	ẤNG
AANGX	ẪNG
ACHSS	ACHS
AWNGF	ẰNG
AWNGJ	ẶNG
AWNGR	ẲNG
AWNGS	ẮNG
AWNGX	ẴNG
Aangf	Ầng
Aangj	Ậng
Aangr	Ẩng
Aangs	Ấng
Aangx	Ẫng
Achss	Achs
Awngf	Ằng
Awngj	Ặng
Awngr	Ẳng
Awngs	Ắng
Awngx	Ẵng
EECHJ	ỆCH
EECHS	ẾCH
EECJH	ỆCH
EENGS	ẾNG
EENHF	ỀNH
EENHJ	ỆNH
EENHR	ỂNH
EENSS	EENS
EEPSS	EEPS
EETSS	EETS
Eechj	Ệch
Eechs	Ếch
Eecjh	Ệch
Eengs	Ếng
Eenhf	Ềnh
Eenhj	Ệnh
Eenhr	Ểnh
Eenss	Eens
Eepss	Eeps
Eetss	Eets
ICHJJ	ICHJ
IEECF	IỀC
IEECJ	IỆC
IEECR	IỂC
IEECS	IẾC
IEECX	IỄC
IEEJT	IỆT
IEEMF	IỀM
IEEMJ	IỆM
IEEMR	IỂM
IEEMS	IẾM
IEEMX	IỄM
IEENF	IỀN
IEENG	IÊNG
IEENJ	IỆN
IEENR	IỂN
IEENS	IẾN
IEENX	IỄN
IEEPF	IỀP
IEEPJ	IỆP
IEEPR	IỂP
IEEPS	IẾP
IEEPX	IỄP
IEEST	IẾT
IEETJ	IỆT
IEETS	IẾT
IEEUF	IỀU
IEEUJ	IỆU
IEEUR	IỂU
IEEUS	IẾU
IEEUX	IỄU
INHRR	INHR
INHXX	INHX
Ichjj	Ichj
Ieecf	Iềc
Ieecj	Iệc
Ieecr	Iểc
Ieecs	Iếc
Ieecx	Iễc
Ieejt	Iệt
Ieemf	Iềm
Ieemj	Iệm
Ieemr	Iểm
Ieems	Iếm
Ieemx	Iễm
Ieenf	Iền
Ieeng	Iêng
Ieenj	Iện
Ieenr	Iển
Ieens	Iến
Ieenx	Iễn
Ieepf	Iềp
Ieepj	Iệp
Ieepr	Iểp
Ieeps	Iếp
Ieepx	Iễp
Ieest	Iết
Ieetj	Iệt
Ieets	Iết
Ieeuf	Iều
Ieeuj	Iệu
Ieeur	Iểu
Ieeus	Iếu
Ieeux	Iễu
Inhrr	Inhr
Inhxx	Inhx
OACHF	OÀCH
OACHJ	OẠCH
OACHR	OẢCH
OACHS	OÁCH
OACHX	OÃCH
OACSS	OACS
OANGF	OÀNG
OANGJ	OẠNH
OANGR	OẢNG
OANGS	OÁNG
OANGX	OÃNG
OANHF	OÀNH
OANHJ	OẠNG
OANHR	OẢNH
OANHS	OÁNH
OANHX	OÃNH
OAWCJ	OẶC
OAWCS	OẮC
OAWNF	OẰN
OAWNG	OĂNG
OAWNJ	OẶN
OAWNR	OẲN
OAWNS	OẮN
OAWNX	OẴN
OAWTF	OẰT
OAWTJ	OẶT
OAWTR	OẲT
OAWTS	OẮT
OAWTX	OẴT
OONGF	ỒNG
OONGJ	ỘNG
OONGR	ỔNG
OONGS	ỐNG
OONGX	ỖNG
OOTSS	OOTS
Oachf	Oàch
Oachj	Oạch
Oachr	Oảch
Oachs	Oách
Oachx	Oãch
Oacss	Oacs
Oangf	Oàng
Oangj	Oạnh
Oangr	Oảng
Oangs	Oáng
Oangx	Oãng
Oanhf	Oành
Oanhj	Oạng
Oanhr	Oảnh
Oanhs	Oánh
Oanhx	Oãnh
Oawcj	Oặc
Oawcs	Oắc
Oawnf	Oằn
Oawng	Oăng
Oawnj	Oặn
Oawnr	Oẳn
Oawns	Oắn
Oawnx	Oẵn
Oawtf	Oằt
Oawtj	Oặt
Oawtr	Oẳt
Oawts	Oắt
Oawtx	Oẵt
Oongf	Ồng
Oongj	Ộng
Oongr	Ổng
Oongs	Ống
Oongx	Ỗng
Ootss	Oots
UAANF	UẦN
UAANG	UÂNG
UAANJ	UẬN
UAANR	UẨN
UAANS	UẤN
UAANX	UẪN
UAATF	UẦT
UAATJ	UẬT
UAATR	UẨT
UAATS	UẤT
UAATX	UẪT
UOOCF	UỒC
UOOCJ	UỘC
UOOCR	UỔC
UOOCS	UỐC
UOOCX	UỖC
UOOIF	UỒI
UOOIJ	UỘI
UOOIR	UỔI
UOOIS	UỐI
UOOIX	UỖI
UOOJC	UỘC
UOOJI	UỘI
UOOMF	UỒM
UOOMJ	UỘM
UOOMR	UỔM
UOOMS	UỐM
UOOMX	UỖM
UOONF	UỒN
UOONG	UÔNG
UOONJ	UỘN
UOONR	UỔN
UOONS	UỐN
UOONX	UỖN
UOOSC	UỐC
UOOSI	UỐI
UOOSS	UOOS
UOOTF	UỒT
UOOTJ	UỘT
UOOTR	UỔT
UOOTS	UỐT
UOOTX	UỖT
UOWCJ	ƯỢC
UOWCS	ƯỚC
UOWIF	ƯỜI
UOWIJ	ƯỢI
UOWIR	ƯỞI
UOWIS	ƯỚI
UOWIX	ƯỠI
UOWMF	ƯỜM
UOWMJ	ƯỢM
UOWMR	ƯỞM
UOWMS	ƯỚM
UOWMX	ƯỠM
UOWNF	ƯỜN
UOWNG	ƯƠNG
UOWNJ	ƯỢN
UOWNR	ƯỞN
UOWNS	ƯỚN
UOWNX	ƯỠN
UOWPF	ƯỜP
UOWPJ	ƯỢP
UOWPR	ƯỞP
UOWPS	ƯỚP
UOWPX	ƯỠP
UOWTF	ƯỜT
UOWTJ	ƯỢT
UOWTR	ƯỞT
UOWTS	ƯỚT
UOWTX	ƯỠT
UWNGF	ỪNG
UWNGJ	ỰNG
UWNGR	ỬNG
UWNGS	ỨNG
UWNGX	ỮNG
UWOWC	ƯƠC
UWOWF	ƯỜ
UWOWI	ƯƠI
UWOWJ	ƯỢ
UWOWM	ƯƠM
UWOWN	ƯƠN
UWOWP	ƯƠP
UWOWR	ƯỞ
UWOWS	ƯỚ
UWOWT	ƯƠT
UWOWU	ƯƠU
UWOWX	ƯỠ
UYCHF	UỲCH
UYCHJ	UỴCH
UYCHR	UỶCH
UYCHS	UÝCH
UYEEF	UYỀ
UYEEN	UYÊN
UYEES	UYẾ
UYEET	UYÊT
UYNHF	UỲNH
UYNHS	UÝNH
Uaanf	Uần
Uaang	Uâng
Uaanj	Uận
Uaanr	Uẩn
Uaans	Uấn
Uaanx	Uẫn
Uaatf	Uầt
Uaatj	Uật
Uaatr	Uẩt
Uaats	Uất
Uaatx	Uẫt
Uoocf	Uồc
Uoocj	Uộc
Uoocr	Uổc
Uoocs	Uốc
Uoocx	Uỗc
Uooif	Uồi
Uooij	Uội
Uooir	Uổi
Uoois	Uối
Uooix	Uỗi
Uoojc	Uộc
Uooji	Uội
Uoomf	Uồm
Uoomj	Uộm
Uoomr	Uổm
Uooms	Uốm
Uoomx	Uỗm
Uoonf	Uồn
Uoong	Uông
Uoonj	Uộn
Uoonr	Uổn
Uoons	Uốn
Uoonx	Uỗn
Uoosc	Uốc
Uoosi	Uối
Uooss	Uoos
Uootf	Uồt
Uootj	Uột
Uootr	Uổt
Uoots	Uốt
Uootx	Uỗt
Uowcj	Ược
Uowcs	Ước
Uowif	Ười
Uowij	Ượi
Uowir	Ưởi
Uowis	Ưới
Uowix	Ưỡi
Uowmf	Ườm
Uowmj	Ượm
Uowmr	Ưởm
Uowms	Ướm
Uowmx	Ưỡm
Uownf	Ườn
Uowng	Ương
Uownj	Ượn
Uownr	Ưởn
Uowns	Ướn
Uownx	Ưỡn
Uowpf	Ườp
Uowpj	Ượp
Uowpr	Ưởp
Uowps	Ướp
Uowpx	Ưỡp
Uowtf	Ườt
Uowtj	Ượt
Uowtr	Ưởt
Uowts	Ướt
Uowtx	Ưỡt
Uwngf	Ừng
Uwngj	Ựng
Uwngr	Ửng
Uwngs	Ứng
Uwngx	Ững
Uwowc	Ươc
Uwowf	Ườ
Uwowi	Ươi
Uwowj	Ượ
Uwowm	Ươm
Uwown	Ươn
Uwowp	Ươp
Uwowr	Ưở
Uwows	Ướ
Uwowt	Ươt
Uwowu	Ươu
Uwowx	Ưỡ
Uychf	Uỳch
Uychj	Uỵch
Uychr	Uỷch
Uychs	Uých
Uyeef	Uyề
Uyeen	Uyên
Uyees	Uyế
Uyeet	Uyêt
Uynhf	Uỳnh
Uynhs	Uýnh
WOWCJ	ƯỢC
WOWCS	ƯỚC
WOWIF	ƯỜI
WOWIJ	ƯỢI
WOWIR	ƯỞI
WOWIS	ƯỚI
WOWIX	ƯỠI
WOWMF	ƯỜM
WOWMJ	ƯỢM
WOWMR	ƯỞM
WOWMS	ƯỚM
WOWMX	ƯỠM
WOWNF	ƯỜN
WOWNG	ƯƠNG
WOWNJ	ƯỢN
WOWNR	ƯỞN
WOWNS	ƯỚN
WOWNX	ƯỠN
WOWPF	ƯỜP
WOWPJ	ƯỢP
WOWPR	ƯỞP
WOWPS	ƯỚP
WOWPX	ƯỠP
WOWTF	ƯỜT
WOWTJ	ƯỢT
WOWTR	ƯỞT
WOWTS	ƯỚT
WOWTX	ƯỠT
Wowcj	Ược
Wowcs	Ước
Wowif	Ười
Wowij	Ượi
Wowir	Ưởi
Wowis	Ưới
Wowix	Ưỡi
Wowmf	Ườm
Wowmj	Ượm
Wowmr	Ưởm
Wowms	Ướm
Wowmx	Ưỡm
Wownf	Ườn
Wowng	Ương
Wownj	Ượn
Wownr	Ưởn
Wowns	Ướn
Wownx	Ưỡn
Wowpf	Ườp
Wowpj	Ượp
Wowpr	Ưởp
Wowps	Ướp
Wowpx	Ưỡp
Wowtf	Ườt
Wowtj	Ượt
Wowtr	Ưởt
Wowts	Ướt
Wowtx	Ưỡt
YEEMF	YỀM
YEEMJ	YỆM
YEEMR	YỂM
YEEMS	YẾM
YEEMX	YỄM
YEENF	YỀN
YEENG	YÊNG
YEENJ	YỆN
YEENR	YỂN
YEENS	YẾN
YEENX	YỄN
YEEST	YẾT
YEETF	YỀT
YEETJ	YỆT
YEETR	YỂT
YEETS	YẾT
YEETX	YỄT
YEEUF	YỀU
YEEUJ	YỆU
YEEUR	YỂU
YEEUS	YẾU
YEEUX	YỄU
Yeemf	Yềm
Yeemj	Yệm
Yeemr	Yểm
Yeems	Yếm
Yeemx	Yễm
Yeenf	Yền
Yeeng	Yêng
Yeenj	Yện
Yeenr	Yển
Yeens	Yến
Yeenx	Yễn
Yeest	Yết
Yeetf	Yềt
Yeetj	Yệt
Yeetr	Yểt
Yeets	Yết
Yeetx	Yễt
Yeeuf	Yều
Yeeuj	Yệu
Yeeur	Yểu
Yeeus	Yếu
Yeeux	Yễu
aangf	ầng
aangj	ậng
aangr	ẩng
aangs	ấng
aangx	ẫng
achss	achs
awngf	ằng
awngj	ặng
awngr	ẳng
awngs	ắng
awngx	ẵng
eechj	ệch
eechs	ếch
eecjh	ệch
eengs	ếng
eenhf	ềnh
eenhj	ệnh
eenhr	ểnh
eenss	eens
eepss	eeps
eetss	eets
ichjj	ichj
ieecf	iềc
ieecj	iệc
ieecr	iểc
ieecs	iếc
ieecx	iễc
ieejt	iệt
ieemf	iềm
ieemj	iệm
ieemr	iểm
ieems	iếm
ieemx	iễm
ieenf	iền
ieeng	iêng
ieenj	iện
ieenr	iển
ieens	iến
ieenx	iễn
ieepf	iềp
ieepj	iệp
ieepr	iểp
ieeps	iếp
ieepx	iễp
ieest	iết
ieetj	iệt
ieets	iết
ieeuf	iều
ieeuj	iệu
ieeur	iểu
ieeus	iếu
ieeux	iễu
inhrr	inhr
inhxx	inhx
oachf	oàch
oachj	oạch
oachr	oảch
oachs	oách
oachx	oãch
oacss	oacs
oangf	oàng
oangj	oạnh
oangr	oảng
oangs	oáng
oangx	oãng
oanhf	oành
oanhj	oạng
oanhr	oảnh
oanhs	oánh
oanhx	oãnh
oawcj	oặc
oawcs	oắc
oawnf	oằn
oawng	oăng
oawnj	oặn
oawnr	oẳn
oawns	oắn
oawnx	oẵn
oawtf	oằt
oawtj	oặt
oawtr	oẳt
oawts	oắt
oawtx	oẵt
oongf	ồng
oongj	ộng
oongr	ổng
oongs	ống
oongx	ỗng
ootss	oots
uaanf	uần
uaang	uâng
uaanj	uận
uaanr	uẩn
uaans	uấn
uaanx	uẫn
uaatf	uầt
uaatj	uật
uaatr	uẩt
uaats	uất
uaatx	uẫt
uoocf	uồc
uoocj	uộc
uoocr	uổc
uoocs	uốc
uoocx	uỗc
uooif	uồi
uooij	uội
uooir	uổi
uoois	uối
uooix	uỗi
uoojc	uộc
uooji	uội
uoomf	uồm
uoomj	uộm
uoomr	uổm
uooms	uốm
uoomx	uỗm
uoonf	uồn
uoong	uông
uoonj	uộn
uoonr	uổn
uoons	uốn
uoonx	uỗn
uoosc	uốc
uoosi	uối
uooss	uoos
uootf	uồt
uootj	uột
uootr	uổt
uoots	uốt
uootx	uỗt
uowcj	ược
uowcs	ước
uowif	ười
uowij	ượi
uowir	ưởi
uowis	ưới
uowix	ưỡi
uowmf	ườm
uowmj	ượm
uowmr	ưởm
uowms	ướm
uowmx	ưỡm
uownf	ườn
uowng	ương
uownj	ượn
uownr	ưởn
uowns	ướn
uownx	ưỡn
uowpf	ườp
uowpj	ượp
uowpr	ưởp
uowps	ướp
uowpx	ưỡp
uowtf	ườt
uowtj	ượt
uowtr	ưởt
uowts	ướt
uowtx	ưỡt
uwngf	ừng
uwngj	ựng
uwngr	ửng
uwngs	ứng
uwngx	ững
uwowc	ươc
uwowf	ườ
uwowi	ươi
uwowj	ượ
uwowm	ươm
uwown	ươn
uwowp	ươp
uwowr	ưở
uwows	ướ
uwowt	ươt
uwowu	ươu
uwowx	ưỡ
uychf	uỳch
uychj	uỵch
uychr	uỷch
uychs	uých
uyeef	uyề
uyeen	uyên
uyees	uyế
uyeet	uyêt
uynhf	uỳnh
uynhs	uýnh
wowcj	ược
wowcs	ước
wowif	ười
wowij	ượi
wowir	ưởi
wowis	ưới
wowix	ưỡi
wowmf	ườm
wowmj	ượm
wowmr	ưởm
wowms	ướm
wowmx	ưỡm
wownf	ườn
wowng	ương
wownj	ượn
wownr	ưởn
wowns	ướn
wownx	ưỡn
wowpf	ườp
wowpj	ượp
wowpr	ưởp
wowps	ướp
wowpx	ưỡp
wowtf	ườt
wowtj	ượt
wowtr	ưởt
wowts	ướt
wowtx	ưỡt
yeemf	yềm
yeemj	yệm
yeemr	yểm
yeems	yếm
yeemx	yễm
yeenf	yền
yeeng	yêng
yeenj	yện
yeenr	yển
yeens	yến
yeenx	yễn
yeest	yết
yeetf	yềt
yeetj	yệt
yeetr	yểt
yeets	yết
yeetx	yễt
yeeuf	yều
yeeuj	yệu
yeeur	yểu
yeeus	yếu
yeeux	yễu
IEENGF	IỀNG
IEENGJ	IỆNG
IEENGR	IỂNG
IEENGS	IẾNG
IEENGX	IỄNG
Ieengf	Iềng
Ieengj	Iệng
Ieengr	Iểng
Ieengs	Iếng
Ieengx	Iễng
OAWNGF	OẰNG
OAWNGJ	OẶNG
OAWNGR	OẲNG
OAWNGS	OẮNG
OAWNGX	OẴNG
Oawngf	Oằng
Oawngj	Oặng
Oawngr	Oẳng
Oawngs	Oắng
Oawngx	Oẵng
UAANGF	UẦNG
UAANGJ	UẬNG
UAANGR	UẨNG
UAANGS	UẤNG
UAANGX	UẪNG
UOONGF	UỒNG
UOONGJ	UỘNG
UOONGR	UỔNG
UOONGS	UỐNG
UOONGX	UỖNG
UOWNGF	ƯỜNG
UOWNGJ	ƯỢNG
UOWNGR	ƯỞNG
UOWNGS	ƯỚNG
UOWNGX	ƯỠNG
UWOWCJ	ƯỢC
UWOWCS	ƯỚC
UWOWIF	ƯỜI
UWOWIJ	ƯỢI
UWOWIR	ƯỞI
UWOWIS	ƯỚI
UWOWIX	ƯỠI
UWOWMF	ƯỜM
UWOWMJ	ƯỢM
UWOWMR	ƯỞM
UWOWMS	ƯỚM
UWOWMX	ƯỠM
UWOWNF	ƯỜN
UWOWNG	ƯƠNG
UWOWNJ	ƯỢN
UWOWNR	ƯỞN
UWOWNS	ƯỚN
UWOWNX	ƯỠN
UWOWPF	ƯỜP
UWOWPJ	ƯỢP
UWOWPR	ƯỞP
UWOWPS	ƯỚP
UWOWPX	ƯỠP
UWOWTF	ƯỜT
UWOWTJ	ƯỢT
UWOWTR	ƯỞT
UWOWTS	ƯỚT
UWOWTX	ƯỠT
UWOWUJ	ƯỢU
UWOWUS	ƯỚU
UYEEJN	UYỆN
UYEEJT	UYỆT
UYEENF	UYỀN
UYEENJ	UYỆN
UYEENR	UYỂN
UYEENS	UYẾN
UYEENX	UYỄN
UYEERN	UYỂN
UYEETF	UYỀT
UYEETJ	UYỆT
UYEETR	UYỂT
UYEETS	UYẾT
UYEETX	UYỄT
UYEEXN	UYỄN
Uaangf	Uầng
Uaangj	Uậng
Uaangr	Uẩng
Uaangs	Uấng
Uaangx	Uẫng
Uoongf	Uồng
Uoongj	Uộng
Uoongr	Uổng
Uoongs	Uống
Uoongx	Uỗng
Uowngf	Ường
Uowngj	Ượng
Uowngr	Ưởng
Uowngs	Ướng
Uowngx	Ưỡng
Uwowcj	Ược
Uwowcs	Ước
Uwowif	Ười
Uwowij	Ượi
Uwowir	Ưởi
Uwowis	Ưới
Uwowix	Ưỡi
Uwowmf	Ườm
Uwowmj	Ượm
Uwowmr	Ưởm
Uwowms	Ướm
Uwowmx	Ưỡm
Uwownf	Ườn
Uwowng	Ương
Uwownj	Ượn
Uwownr	Ưởn
Uwowns	Ướn
Uwownx	Ưỡn
Uwowpf	Ườp
Uwowpj	Ượp
Uwowpr	Ưởp
Uwowps	Ướp
Uwowpx	Ưỡp
Uwowtf	Ườt
Uwowtj	Ượt
Uwowtr	Ưởt
Uwowts	Ướt
Uwowtx	Ưỡt
Uwowuj	Ượu
Uwowus	Ướu
Uyeejn	Uyện
Uyeejt	Uyệt
Uyeenf	Uyền
Uyeenj	Uyện
Uyeenr	Uyển
Uyeens	Uyến
Uyeenx	Uyễn
Uyeern	Uyển
Uyeetf	Uyềt
Uyeetj	Uyệt
Uyeetr	Uyểt
Uyeets	Uyết
Uyeetx	Uyễt
Uyeexn	Uyễn
WOWNGF	ƯỜNG
WOWNGJ	ƯỢNG
WOWNGR	ƯỞNG
WOWNGS	ƯỚNG
WOWNGX	ƯỠNG
Wowngf	Ường
Wowngj	Ượng
Wowngr	Ưởng
Wowngs	Ướng
Wowngx	Ưỡng
YEENGF	YỀNG
YEENGJ	YỆNG
YEENGR	YỂNG
YEENGS	YẾNG
YEENGX	YỄNG
Yeengf	Yềng
Yeengj	Yệng
Yeengr	Yểng
Yeengs	Yếng
Yeengx	Yễng
ieengf	iềng
ieengj	iệng
ieengr	iểng
ieengs	iếng
ieengx	iễng
oawngf	oằng
oawngj	oặng
oawngr	oẳng
oawngs	oắng
oawngx	oẵng
uaangf	uầng
uaangj	uậng
uaangr	uẩng
uaangs	uấng
uaangx	uẫng
uoongf	uồng
uoongj	uộng
uoongr	uổng
uoongs	uống
uoongx	uỗng
uowngf	ường
uowngj	ượng
uowngr	ưởng
uowngs	ướng
uowngx	ưỡng
uwowcj	ược
uwowcs	ước
uwowif	ười
uwowij	ượi
uwowir	ưởi
uwowis	ưới
uwowix	ưỡi
uwowmf	ườm
uwowmj	ượm
uwowmr	ưởm
uwowms	ướm
uwowmx	ưỡm
uwownf	ườn
uwowng	ương
uwownj	ượn
uwownr	ưởn
uwowns	ướn
uwownx	ưỡn
uwowpf	ườp
uwowpj	ượp
uwowpr	ưởp
uwowps	ướp
uwowpx	ưỡp
uwowtf	ườt
uwowtj	ượt
uwowtr	ưởt
uwowts	ướt
uwowtx	ưỡt
uwowuj	ượu
uwowus	ướu
uyeejn	uyện
uyeejt	uyệt
uyeenf	uyền
uyeenj	uyện
uyeenr	uyển
uyeens	uyến
uyeenx	uyễn
uyeern	uyển
uyeetf	uyềt
uyeetj	uyệt
uyeetr	uyểt
uyeets	uyết
uyeetx	uyễt
uyeexn	uyễn
wowngf	ường
wowngj	ượng
wowngr	ưởng
wowngs	ướng
wowngx	ưỡng
yeengf	yềng
yeengj	yệng
yeengr	yểng
yeengs	yếng
yeengx	yễng
UWOWNGF	ƯỜNG
UWOWNGJ	ƯỢNG
UWOWNGR	ƯỞNG
UWOWNGS	ƯỚNG
UWOWNGX	ƯỠNG
Uwowngf	Ường
Uwowngj	Ượng
Uwowngr	Ưởng
Uwowngs	Ướng
Uwowngx	Ưỡng
uwowngf	ường
uwowngj	ượng
uwowngr	ưởng
uwowngs	ướng
uwowngx	ưỡng
